XXXXXXXXXXXXXXXX
X1 C  C2    3  X
XXXH XXXX   HXHX
X  H   X    HX X
XHXXXXHX C  HX X
XHXCCXHX X  HX X
XH HH H     HX X
XXXXXXXX  X HX X
XDX2  3X  C HXPX
XXXXXXXXXXXXXXXX