XXXXXXXXXXXXXXXXXXXXXXXXXXX
XP1                  X  2CX
XXX       HXXHXXH    X  XXX
X        HX1 C 2XH   X   CX
XHXXXXXXXXXXXXXXXXXXXXXXHXX 
XH       7X3   4X5       CX 
XXXXXXXXXXXXXXXXXXXXXXXHXXX
X  3    4  6XDX7  6    H  X
XHXX    X HXX XXH X    XXHX
XH 5   C  HC   CH  C     HX
XXXX   XXXXX X XXXXX   HXXX
XC  HXH                H CX
XXXXXXXXXXXXXXXXXXXXXXXXXXX